########################################################
#                   #                                  #
#                   #                                  #
#                   #                                  #
#                   #                                  #
#                   #                                  #
#                   #                                  #
#                   #                                  #
#                   #                                  #
#                                                      #
#                                                      #
#               O                                      #
#                                                      #
#                            P                         #
#                     @                                #
#                           M                          #
#               ?                                      #
#                                                      #
#                                                      #
#                                                      #
#                                                      #
#                                                      #
#                                                      #
#                                                      #
#                                                      #
########################################################
